передвигаться с тяжестью - get around
суетиться - potter around
помыкать/командовать - order around
рыскать - roam around
развиваться на ветру - blow around in the wind
бродить - wander around
сидеть без дела - sit around
валяться - lye around
быть неподалеку - to be around somewhere
сопровождать - show around
собраться вокруг ч,к либо - gather around
приходить в гости - come around
обойти - walk around
обойти трудности - get around
никогда руки не доходят до … - never get around to doing
обернуться - turn around
оглянуться - spun around
достаточное количество (enough) - go around
держать запас - keep around
пристально смотреть - stare around
смотреть с изумлением - gaze around
смотреть с любопытством - gape around
свирепо смотреть - glare around
вглядываться, щуриться - peer around
метаться, носиться, бегать - race around
to swim here and there - swim around
подглядывать - peep around
ощупать карман - finger around in pocket
отсутствовать - to be away
отсутствовать because of грипп - to be away with flu
не ходить (from school) - stay away
уносить - carry away
утащить - drag away
оттолкнуть - push away
держаться подальше - keep away
вырваться из - break away from
счистить - brush away
отрезать - cut away
оттянуть/оттащить - pull away
отмести - sweep away
оторвать - tear away
выбросить - through away
выкипать - boil away
растаять - melt away
смывать - wash away
изнашивать - wear away
транжирить - fritter away
тратить время - idle away
коротать время - while away
стихать - die away
выцветать/состариться - fade away
оправдать - explain away
упорно работать над - slog away
работать долго без перерыва - hammer away